     ----------
     |        |
     O        |
    \|/       |
    / \       |
              |
    ------------------