     ----------
     |        |
     O        |
    \|/       |
    /         |
              |
    ------------------